WWWWWWWWWWWWWWWWWWWWWWWWWWWWWWSWWWWWWWWWWWWWWWWWWWWWWWWWWWWW
W         WW                 W W            W              W
W    R    HW          WWWWWWWW H            W        R  R  W
W         WW          W      H W            H              W
W   WWWWWWWW          W WWWWWW W       WWWWWWWHWWWW        W
W   WWWWWWWW          WHW    H W R     H          W        W
W   WW                WWW    W W   WWWWW WWWWWWWW W        W
W   WW           J           W WWWWW     W      W W        W
W   WW                       W       WWWWW      W W        W
W   WW   WWWWWWWWWWWWWWWWWWWWWWWWWWWWW          W WWWWWWHWWW
W   WW   W         WWWWHWWWWWWWWWWWWWW     R    W WWWWWWWWWW
W   WW   W WWWWWWW W                            H H    WWWWW
W   WWH  W W     W H                            W WWWW WWWWW
W   WW   W W  R  W W                            W WWWW WWWWW
W   D    W W     W WWWWWWWWWWWWWWWWWWWWWWWWWWWHWW WWWW    WW
W   WW   W W     W                                WWWWWWW WW
W   WW   W W    WWWWHWWWWWWWWWWWWWWWWWWWWWWWWWWHWWWWWWWWW WW
W   WW   W WWWHWW                             W           WW
W   WW   W  M  W                              W WWWWWWWWWWWW
W   WW   WWWWW W                              W WWWW       W
W   WW       W WWWWWWWWWWWWWWWW     WWWWWWWW  W    W    R  W
W   WW       W M    M     M   W     W R    WWWWWWW W       W
W   WW       WHWWWWWWWWWWWWWW W     W WWWW         W       W
W   WW                      W W     WHW  WWWWWWWWWWW WWWHWWW
W   WWWWWWWW     WWWHW      W W                      W     W
W   WWWWWWWW         W      W WWWWWWWHWWWWWWWWWWWWWWHW     W
W         WW     WW  H      W    M        M        M H     W
W    R    WW      WWWW      WWWWWWWWWWWWWWWWWWWWWWWW W  K  W
W         WW                                       W W     W
WWWWWWWWWWWWWWWWWWWWWWWWWWWWWWWWWWWWWWWWWWWWWWWWWWWWWWWWWWWW