WWWWWWWWWWWWWWWWWWWWWWWWWWWWWWWWWWWWWWWWWWWWWWWWWWWWWWWWWWWW
S       W                 W          H            H        W
WHWWWWW W                 W R   WWHWWW WWWWWWWWWW WWW    R W
W W   W W              WWWWHWWWWW      W        W   W      W
WRW   W W        WWWWHWW          WWWWWW R      WWW WWW    W
W W   W W  R     W       WWHWWWWWWW               W   W    W
W W   W W        W WWWWWWW                        WWW W    W
W W   W WWWWWWWWWW W       J  WWWWHWWWWWWWWWWWWW    W W    W
W W   W            W          W                W    W WHWWWW
W W   WWWWWWWWWWWWWWWWWWWWWWWWW WWWWWWWWWWWWWW W    W      W
W W                           W W        WWWWW W    WWWHWW W
W H                           W H        WWWWW W         W W
W W              WWWWHWW      W W         WWWW WR        W W
W WWWWWWWWWWWWWWWW     W      W WWW         WW WWWWWWWWWWW W
W                   R  H      H WWWW         W             W
WWWWWHWWWWWWWWWWWW     W      W WWWW         WWWWWWWWWWWWWWW
W                WWHWWWW      W WWWWWW      WWW            W
W                             W WWWWWWW    WWWWW   R       W
W                             W WWWWWWW    WWWWWW        R W
W   WWW    WWWWWWWWWWWWWWWWWWWW WWWWWWW     WWWWWW         W
W   WHW    W                    WWWWWW           D    R    W
W   W WWWW W WWWWWWHWWWWWWWWWWWWWWWW            WW         W
W   W    W W WWWW     WWWWWWWWWWWWW       WWWWWWW        R W
W WWWWWW W W WWWWW                       WWWWWWW   R       W
W W      W W WWWWWWWWWWWWWWWWWWWWWWWWWWWWWWWWWW            W
W W WWWWWW W WWWWWWWWWWWWWWWWWWWWWWWWWWWWWWWWWWWWWWWWWWWWWWW
W W    W   W  M       M    M    M     M       M    M   WWWWW
W WWWW W   WWWWWWWWWWWWWWWWWWWWWWWWWWWWWWWWWWWWWWWWWWW WWWWW
W    WKW                                             W WWWWW
WWWWWWWWWWWWWWWWWWWWWWWWWWWWWWWWWWWWWWWWWWWWWWWWWWWWWWWWWWWW
