WWWWWWWWWWWWWWWWWWWWWWWWWWWWWWWWWWWWWWWWWWWWWWWWWWWWWWWWWWWW
W   R                                                      W
W                                    J                     W
W  WWWWWWHWWWWWWWWWWWWWWWWWWHWWWWWWWWWWWWWWWWWWWHWWWWWWWWWWW
W  W                    M                                  W
W  W WWWWWWWHWWWWWWWWWWWWWWWWWWWWWWWWWWWWWWWWWWWWWWWWWWWWW W
W  W WR                               R                  W W
W  W H                   R                               H W
W  W W  WWWWHWWWWWWWWWWWWWWWWWWWWWWWWWWWWWWWWWWWWWWWWWWWWW W
WR W W  W              M                              W RW W
W  W W  W WWWWWWWWWWWWWWWWWWWWWWWWWWWWWWWWWWWWWWWWWWW W  W W
W  H W  H W     R                                W  W W  W W
W  W W  W W                               R      W  W W  W W
W  W W  W W  WWWWWWWWWWWWWWWHWWWWWWWWHWWWWWWWWWWWW  W W  W W
W  W W  W W  W                                   W  W W  W W
W  W W  W W  W WWWWWWWWWWWWWWWWWWWWWWWWWWWWWWWWW W  W WR W W
W  W W  W W  H                                SW W  W H  W W
W  W W  W WWWWWWWWWWWWWWWWWWWWWWWWWWWWWWWWWWWWWW W  W W  W W
W  W W  W             M                          W  W W  W W
W  W W  WWWWWWWWWWWWWWWWWWWWWWWWWWWWWWWWWWWWWWWWWW  W W  W W
W RW W  W          R               R                W W  W W
W  W W  W                                           W W  W W
W  W WWWWWHWWWWWWWWWWWWWWWWWWWWWWWWWWWWWWWWWWWWWWWWWW W RW W
W  W                     M                            W  W W
W  WWWWWWWWWWWWWWWWWWWWWWWWWWWWWWWWWWWHWWWWWWWWWHWWWWWW  W W
W  W       R                                             W W
W  H                           R                   R     H W
W  WWWWWWWHWWWWWWWWWWWWWWWWWWWWWWWWWWHHWWWWWWWWWWWWWWWWWWW W
W  W                 M                                     W
WWWWWWWWWWWWWWWWWWWWWWWWWWWWWWWWWWWWWWWWWWWWWWWWWWWWWWWWWWWW