WWWWWWWWWWWWWWWWWWWWWWWWWWWWWWWWWWWWWWWWWWWWWWWWWWWWWWWWWWWW
W M    W   W              W       W                        W
WWWWWW W   W              H       H                        W
W M    W   W              WWWWWWWWW                        W
W WWWWWW   W   J          W       W                        W
W M    WWWWW              W WWWWW W                        W
WWWWWW H   H              W W   W W                        W
W  M   WWWWW              W W R W W                        W
W WWWWWWW  W              W W   W W                        W
W W     W  W              W W   W W                        W
W WW  R H  H              W W   W W                        W
W  WW   W  W              W W   W W                        W
WW  WWWWWWWWWWWWHWWWWWWWWWW W   W W                        W
WWW  M      M W   W         W   W W                      WWW
W WWWWWWWWWWW W   W WWWWWWWWW   W W  WWWWWWWWWWHWWWWWWWWWSSS
W           W WWWWW W       W   W W WW                   SRS
W           W       W       W   W WWW  WWWWWWWWWHWWWWWWWWSSS
W    R      WWWWHWWWW       W   W WW  WW                 WWW
W                           H   W H  WW                    W
W                           W   W W WW         R           W
W         WWHWW   WWHWWWWWWWW   W W W                      W
W         W   W   W   W     W   W W W                      W
W         W   WWWWW   W     W   W W WWWWWWWWWWWWHWW        W
W         W           W     W   W W               W        W
W         W     R     W     W   W WWWWWWWWWWWWWWW W        W
W         WWWWWWWWWWWWW     W   W                 W        W
W         W                 W   WWWWWWWWWWWWWWWHWWW        W
W         H           R     H                    W         W
W         W                 W                    W         W
WWWWWWWWWWWWWWWWWWWWWWWWWWWWWWWWWWWWWWWWWWWWWWWWWWWWWWWWWWWW