WWWWWWWWWWWWWWWWWWWWWWWWWWWWWWWWWWWWWWWWWWWWWWWWWWWWWWWWWWWW
WS      W               W            H            H        W
W WWWWW W               W            W WWWWWWWWWW WWW    R W
W WW  W W      WWWWWWWHWWWWHWWWWWWHWWW W        W   W      W
W W   W W      W                       W R      WWW WWW    W
W W   W W  R   W   WWWWWWWWHWWWWWWWWWWWW          W   W    W
W W   W W      W   W                              WWW W    W
W W   W WWWWWWWW   WWW        WWWWHWWWWWWWWWWWWW    W WHWWWW
W W   W            WRW    J   W                W    W      W
W W   WWWWWWWWWWWWWWWWWWWWWWWWW WWWWWWWWWWWWWW W    WWWHWW W
W W                           W W            W W         W W
W W                           W W            W W         W W
W W               WWWWHWW     W W            W WR        W W
W WWWWWWWWWWWWWWWWW     W     W W            W WWWWWWWWWWW W
W                    R  H     H W            W             W
WWWWWWWWWWWWWWWWWWW     W     W W            WWWWWWWWWWWWWWW
W                 WWHWWWW     W W                          W
W                             W W                          W
W                             W W                          W
W          WWWWWWWWWWWWWWWWWWWW W                          W
W          W                    W                          W
W          W WWWWWWWHWWWWWWWWWWWW                          W
W          W W                                             W
W          W W                                             W
W          W W                                             W
W          W WWWWWWWWWWWWWWWWWWWWWWWWWWWWWWWWWWWWWWWWWWW   W
W          W                                           W   W
W          WWWWWWWWWWWWWWWWWWWWWWWWWWWWWWWWWWWWWWWWWWW W   W
W                                                    WMW   W
WWWWWWWWWWWWWWWWWWWWWWWWWWWWWWWWWWWWWWWWWWWWWWWWWWWWWWWWWWWW
